###############################
#.............................#
#.C...........................#
#.............................#
#.............########........#
#.............#..D.#M.........#
#.............#...............#
#.............########........#
#P...............C#C..........#
###############################
